WWWWWWWWWWWWWW
WSSSSSSBPFSSSW
WSSSSSSSSSSSSW
WSSSSSSSSSSSSW
WSSFSSSSSBWSSW
WSSSSSSSSSWSSW
WWWWWWWWWWWWWW
