1111111111111     1
10000000000001
10006000300001
10300030004441
10000010011111
10000200300111
11111111111111
